2
2 3
F..
..P
6 8
FPP...PP
FPPP...P
PP......
........
P......P
PPP...PP